000000000000001110000000000000
000000000000001110000000000000
000111000000000000000000111000
000000000111000000011100000000
000000000100000000000100000000
000110000000000000000000011000
000010000000000000000000010000
000010000000000000000000010000
000010011000000000000110010000
000010011000000000000110010000
000010000000000000000000010000
000010000000000000000000010000
000110000000000000000000011000
000000000100000000000100000000
000000000111000000011100000000
000111000000000000000000111000
000000000000001110000000000000
000000000000001110000000000000
